
F 122,122,0
C 255,200,160


SO ./textures/redbrick.xpm
EA ./textures/wood.xpm
WE ./textures/wood.xpm
NO ./textures/greystone.xpm



      1
     11111
    1010011111
   100000111
  111111111
 10000000001111111
100100E00000000001
 10000000001111111
  100000111
   100001
    10001
     101
      1
