NO texture/red.png
SO texture/sky.png
EA texture/moon.png
WE texture/comet.png

C 220,100,0
F 0,30,60


111111111111111111111111111111111111111111111111111
10000000000000000000000000000S000000000000000000001
100000000000000000000000000000000001100000000000001
111111111000000000000000000000000000000000000000001
111111111000000000000000000000000000000000000000001
111100000000000000000000000000000000000000000000001
100000000000000000000000000000000000000000000000001
111111111000000000000000000000000000000000000000001
100000000000000000000000000000000000000000000000001
100000000000000000000000000000000000000000000000001
111111111111111111111111111111111111111111111111111
