NO texture/red.png
SO texture/sky.png
EA texture/moon.png
WE texture/comet.png

C 220,100,0
F 0,30,60


11111111111111111111111
10000000000000000000001
11111111100011111111111
10000000010100000000001
10000000010100000000001
10010001100011000000001
10000001100011000000001
10001000010100000000001
10000000000000000000001
11111111110111111111111
10000000000000000000001
10000000010000000000001
10000000010000000000001
10000000000000000000001
11011111111111111111111
10000000010000000000001
10000000000000000000001
10000000001000000000001
10010000001000000000001
10000000000000000001001
10000000000000000000001
11111111111111111111011
10000000010000000000001
10010000000000000000001
10000000010000010000001
10100000000000001000001
10000000000000000000001
10100000010000000000001
10000000000000000000001
10000100010000000000001
10000100000000000000001
10000000010000000000001
10000100000000000000001
10000000000000000000001
11111111111111111111111
